************************
*         *            *
*    *    *  *****  *  *
*    *    *  *   *  *  *
*    *    *      *  *  *
*    *    ****   ****  *
*S   *           * E   *
************************
