"*************************
*        *             E*
*      **  **************
*     *                 *
* ****************  *   *
*                 *  *  *
* ***********         * *
* *         *************
* * ***** *             *
* * *     * *************
* * * *****             *
* * * ***** *********** *
*                       *
*********** *********** *
***********             *
*********** **************
*********** *************
*         * *           *
*** ******* ******* *****
*                       *
*********** *************
*                       *
*********************** *
*S                      *
*************************"