****************************
*         *            *  E*
*    *    *  *****  *  *   *
*    *    *  *   *  *  *   *
*    *    *      *  *  *   *
*    *    ****   ****  *   *
*S   *           *         *
****************************
