*************************************
*         *                         *
*         *      **************     *
*    *    *  *****   *              *
*    *    *  *       **********     *
*    *    *      *            *     *
*    *    ********    *********     *
*S   *           *     *            *
******     *******     *   **********
*                      *   *        *
******     *************   *  *  *  *
*  E *     *               *  *  *  *
*    *     *  **************  *  *  *
*    *     *  *               *  *  *
*    *     *  *****************  *  *
*    *     *                     *  *
*    *****************************  *
*                                   *
*************************************
