****************
*         *   E*
*    *    *  ***
*    *    *    *
*S   *         *
****************
